##########
#I        #
# ### ### #
#   # #   #
# #########
#         #
#### # ## #
#    # #  #
# ## ### ## 
#M#  #    #
##########
